0 0 17 0 0 0 0 0 0 0 0 0 0 
17 0 17 0 17 96 17 18 18 18 18 0 0 
17 0 17 0 17 32 32 18 0 0 18 0 0 
17 0 17 19 17 32 32 18 18 0 18 0 0 
17 0 0 0 17 17 17 17 17 0 17 0 0 
17 17 17 0 0 0 0 0 0 0 17 0 0 
0 48 17 17 17 17 17 17 17 17 17 0 0 
0 17 0 0 0 17 0 0 0 0 0 0 0 
0 17 96 17 0 17 0 17 17 17 17 0 0 
0 17 0 17 0 17 0 17 0 64 17 0 0 
0 17 0 17 0 17 0 17 0 17 17 0 0 
0 0 0 17 0 0 96 17 0 96 0 0 0 
 
 
 96 96 
 32 32 32 32 0 0 17 17 
17 17 32 32 32 32 32 32 32 0 0 48 48 
